11111111111111111
10000000000101001
10100111111001101
10101100001010101
10111010100000001
10000011011111001
11111000010001001
10110010000100101
10110100101110111
10000111000100001
10110011000100101
10110010000011101
10111001111110101
10110010000010001
10010111110101111
10010000000000001
11111111111111111